w w w w w x x x x x
w e e e w x x x x x
w e b e w x w w w x
w e b e w x w w w x
w w w e w w w s w x
x w w e k e e s w x
x w e e e w e e w x
x w e e e w w w w x
x w w w w w x x x x
x x x x x x x x x x

x x w w w w w x x x
w w w e e e w x x x
w s k b e e w x x x
w w w e b s w x x x
w s w w b e w x x x
w e w e s e w w x x
w b e B b b s w x x
w e e e s e e w x x
w w w w w w w w x x
x x x x x x x x x x

w w w w w x x x x x
w k e w w x x x x x
w s b B e w x x x x
w e e e w w x x x x
w e e e e w x x x x
w w w w w w x x x x
x x x x x x x x x x
x x x x x x x x x x
x x x x x x x x x x
x x x x x x x x x x